#	Simple map
#	Path to north, south, west and east textures
NO	redbrick
SO	barrel
WE	hitler
EA	greystone
#	Floor and ceiling's color
C	22,22,22
F	32,32,32
#	MAP
11111111
11010001
10000001
1000N001
11111111


