F       100  ,100  ,255   
C      20,20,20


  NO textures/wolfenstein/blue_stone.xpm              

    EA textures/wolfenstein/blue_stone.xpm
        WE         textures/wolfenstein/blue_stone.xpm







  SO textures/wolfenstein/blue_stone.xpm

    111111111111111111111111111111111111111111111111111111111111111111111111111111111111111111111111111111111111111111111111111111111111111111111111111111111111111111111111111111111111111111111111111111111111111111
111111E00000000000000000000000000000000000000000000000000000000000000000000000000000000000000000000000000000000000011
11111100000000000000000000000000000000000000000000000000000000000000000000000000000000000000000000000000000000000011
111111111111111111111111111111111111111111111111111111111111111111111111111111111111111111111111111111111111111111111111111111111111111111111111111111111111111111111111111111111111111111111111111111111111111111
