#                                                                              #
# maps/example_inverted.cub                                                    #
# mpuig-ma <mpuig-ma@student.42barcelona.com>                                  #
# Wed Oct 18 12:12:47 2023                                                     #

NO greystone
SO eagle
WE purplestone
EA mossy

F 220,100,0
C 225,30,0

1111111111
1110011101         
1100001101         
1100001101         
1000000001         
1100001101         
1100001101         
1110001101         
  10011101         
11100111001111
11000011100001
11100111110101
10000011001101
11100111000001
10000000000001
11100111000001
  111111000001
11111111110001
10100000110001
11110010110001
11000000000001
11110010100001
11100000100001
10100000100001
11110011100001
10000000100001
10N00000100001
10000000000001
 1111111100001
  1     100001
  1     100001
        100001
        110001
          1111
