NO redbrick
SO wall
WE path_to_the_west_texture.xpm
EA path_to_the_east_texture.xpm

F 220,100,0
C 10,10,200

         1111111111111111111111111
         1000000000110000000000001
         1011000001110000000000001
         1001000000000000000000001
1111111110110000011100000000000011
10000000001100000111011111111111
11110111111111011100000010001
11110111111111011101010010001
11000000110101011100000010001
10000000000000001100000010001
10000N00000000001101010010001
11000001110101011111011110001
11110111 1110101 101111010001
11111111 1111111 111111111111
