NO redbrick
SO redbrick
EA redbrick
WE empty

F 0,0,0
C 0,0,0

1111
11S1
1111
