NO bluestone
SO bluestone
EA bluestone
WE bluestone

F 9,9,9
C 9,9,9,9

1111
1001
1011
1011
1011
1011
1111
