NO       srcs/imgs/wall_text/a.xpm
SO		srcs/imgs/wall_text/b.xpm
EA srcs/imgs/wall_text/c.xpm


F 127, 127, 127
C 135, 206, 250


1111111111111111111111111111
1E00000100100110000000000001
1111111111111111111111111111
