NO barrel
SO barrel
EA barrel
WE barrel

F 0,0,0
C 0,0,0

  10
  11
      11111
      10001
      10S01
      11111
