NO redbrick
SO redbrick
EA redbrick
WE redbrick

C 0,0,0
F 0,0,0

1111111
100N001
1011101
101 101
10   01
1000001
1111111
