NO       a.xpm
SO		b.xpm
EA	c.xpm
WE d.xpm
EA d.xpm

F 127, 127, 127
C 135, 206, 250


1111111111111111111111111111
1E00000100100110000000000001
1111111111111111111111111111
