#                                                                              #
# info_invalid_image_path.cub                                                  #
# mpuig-ma <mpuig-ma@student.42barcelona.com>                                  #
# Wed Oct 18 09:39:45 2023                                                     #

NO redbrick
SO redbrick
WE redbrick
EA redbrick

F  0,0,0
C  0,0,0

1111111111
   1111001
  10001001
1100010011
  1111111
 11111111
