#	Path to north south west and east textures
NO	floor
SO	floor
WE	floor
EA	floor

#	Floor and ceiling's color
C	22,22,22
F	32,32,32

111111111111111111111111
100000000000000000000001
100000000000000000000001
100000000000000000000001
100000000000000000000001
100000000000000000000001
100000000000000000000001
100000000000N00000000001
100000000000000000000001
100000000000000000000001
100000000000000000000001
100000000000000000000001
101000000000000000000001
010111111111111111111111
