


NO bricks.xpm



SO hitler.xpm



EA protoblue.xpm



WE switches.xpm


F 100, 120, 50



C 135, 206, 250


        111111111111111111111111
        1000000000110000000010001
        1011000001110000000001001
        100100000000000000S000001
111111111011000001110000000000001
11100000001100000111011111111111
11110111111111011100000010001
11110111111111011101010010001
11000000110101011100000010001
1000000       001100000010001
10000000000000001101010010001
11000001110101011111011110001
11110111011101010101111010001
11110111111111011101010010001
11000000110101011100000010001
1000000       001100000010001
10000000000000001101010010001
11000001110101011111011110001
11110111011101010101111010001
11110111111111011101010010001
11000000110101011100000010001
1000000       001100000010001
10000000000000001101010010001
11000001110101011111011110001
11110111011101010101111010001
11110111111111011101010010001
11000000110101011100000010001
1000000       001100000010001
10000000000000001101010010001
11000001110101011111011110001
11110111011101010101111010001
11110111111111011101010010001
11000000110101011100000010001
1000000       001100000010001
10000000000000001101010010001
11000001110101011111011110001
11110111011101010101111010001
11110111111111011101010010001
11000000110101011100000010001
1000000       001100000010001
10000000000000001101010010001
11000001110101011111011110001
11110111011101010101111010001
11110111111111011101010010001
11000000110101011100000010001
1000000       001100000010001
10000000000000001101010010001
11000001110101011111011110001
11110111011101010101111010001
11110111111111011101010010001
11000000110101011100000010001
1000000       001100000010001
10000000000000001101010010001
11000001110101011111011110001
11110111011101010101111010001
11110111111111011101010010001
11000000110101011100000010001
1000000       001100000010001
10000000000000001101010010001
11000001110101011111011110001
11110111011101010101111010001
11110111111111011101010010001
11000000110101011100000010001
1000000       001100000010001
10000000000000001101010010001
11000001110101011111011110001
11110111011101010101111010001
11110111111111011101010010001
11000000110101011100000010001
1000000       001100000010001
10000000000000001101010010001
11000001110101011111011110001
11110111011101010101111010001
11110111111111011101010010001
11000000110101011100000010001
1000000       001100000010001
10000000000000001101010010001
11000001110101011111011110001
11110111011101010101111010001
11111111111111111111111111111
