NO	redbrick
SO	redbrick
WE	redbrick
EA	redbrick
C	22,22,22
F	32,32,32

1111
1001
1001
1N01
1111
