#                                                                              #
# maps/rombe.cub                                                               #
# mpuig-ma <mpuig-ma@student.42barcelona.com>                                  #
# Fri Oct 13 15:50:50 2023                                                     #

#	Path to north, south, west and east textures
NO	redbrick
SO	redbrick
WE	redbrick
EA	redbrick

#	Floor and ceiling's color
F	0.0.0
C	255,255,255

#	The map:
     1
    101
   10001
  1111001
 100S00101
11111111111
