#	Simple map

#	Path to north, south, west and east textures
NO	floor
SO	floor
WE	floor
EA	floor

#	Floor and ceiling's color
C	38,121,204
F	76,76,76

#	MAP
11111111
10010001
10100011
1100N1
111111
