#                                                                              #
# maps/valid_map.cub                                                           #
# mpuig-ma <mpuig-ma@student.42barcelona.com>                                  #
# Wed Oct 18 09:36:04 2023                                                     #

NO src/assets/barrel.xpm
WE			barrel
F   4,4, 90
#comment here
SO pillar
 	EA barrel.xpm

C 255,0,0	
# comment there

#	ignored line ?
  11111
  10001
  100N1
  11111
