#                                                                              #
# maps/valid.cub                                                               #
# mpuig-ma <mpuig-ma@student.42barcelona.com>                                  #
# Fri Oct 13 10:52:25 2023                                                     #

NO	greystone
EA	floor
WE	player
F	4,4, 90
#	comment here
SO	path_to_the_south_texture
C	255,0,0	
#	comment there

#	MAP
1111111
1000001
1000011
1000N1
111111
