#                                                                              #
# maps/valid.cub                                                               #
# mpuig-ma <mpuig-ma@student.42barcelona.com>                                  #
# Fri Oct 13 10:52:25 2023                                                     #

NO	floor
EA	wall
WE	player
F	4,4, 90
#	comment here
SO	path_to_the_south_texture
C	255,0,0	
#	comment there

#	MAP
111111
100101
101001
1100S1
111111
