
NO    ./src/assets/bluestone.xpm

EA ./src/assets/bluestone.xpm
WE ./src/assets/bluestone.xpm

SO ./src/assets/bluestone.xpm

F 98,105,109
C 80,130,200

 
    1111111111111111111111111
   10000000000000000000001      
  1000000000000001000000001      
 1000000001000000000000001
1000000E01 10000000000001
 1000000001001000000000001
  1000000000000000000000001
   1000000000000000000000001
  1000000000000000000000001
 11111111111111111111111111111111
