#                                                                              #
# maps/not_so_simple.cub                                                       #
# mpuig-ma <mpuig-ma@student.42barcelona.com>                                  #
# Wed Oct 18 09:32:56 2023                                                     #

#	Path to north, south, west and east textures
NO	greystone
SO	greystone
WE	greystone
EA	greystone

#	Floor and ceiling's color
F	0,0,0
C	255,255,255

#	MAP
   111111
   100111
1110001
1100N1
111111
