NO redbrick
SO redbrick
EA redbrick
WE redbrick

C 10,10,10
F 10,10,10

1111111
1000001
1011101
1010101
1000001
1000S01
1111111
